word	italicized	correct_spelling
Achronim	True	\N
acharonim	True	Achronim
Acharonim	True	Achronim
achronim	True	Achronim
aharonim	True	Achronim
Aharonim	True	Achronim
ahronim	True	Achronim
Ahronim	True	Achronim
akharonim	True	Achronim
Akharonim	True	Achronim
akhronim	True	Achronim
Akhronim	True	Achronim
agudah	True	\N
Agudah	True	\N
ahavah	True	\N
ahava	True	ahavah
akhilah	True	\N
achila	True	akhilah
achilah	True	akhilah
achilla	True	akhilah
achillah	True	akhilah
akhila	True	akhilah
akhilla	True	akhilah
akhillah	True	akhilah
aleinu	False	\N
Alenu	False	aleinu
aliyah	True	\N
aliya	True	aliyah
Alot	True	\N
alot	True	Alot
Amidah	False	\N
amida	False	Amidah
Amida	False	Amidah
amidah	False	Amidah
amirah	True	\N
amira	True	amirah
aninut	True	\N
aninus	True	aninut
arayot	True	\N
arayos	True	arayot
Arukh	True	\N
Aruch	True	Arukh
Asar	True	\N
asar	True	Asar
assar	True	Asar
Assar	True	Asar
Ashkenaz	False	\N
ashkenaz	False	Ashkenaz
Ashkenazi	False	\N
ashkenazi	False	Ashkenazi
ashkenazic	False	Ashkenazi
Ashkenazic	False	Ashkenazi
Ashrei	True	\N
ashrei	True	Ashrei
asiyah	True	\N
asiya	True	asiyah
assur	True	\N
asur	True	assur
assurot	True	\N
assuros	True	assurot
asuros	True	assurot
asurot	True	assurot
Assurot	True	\N
Assuros	True	Assurot
Asuros	True	Assurot
Asurot	True	Assurot
Atzeret	False	\N
Atzeres	False	Atzeret
avadim	True	\N
avaddim	True	avadim
aveil	True	\N
avel	True	aveil
aveilut	True	\N
aveilus	True	aveilut
avelus	True	aveilut
avelut	True	aveilut
Avinu	True	\N
avinu	True	Avinu
avodah	True	\N
avoda	True	avodah
Avodah	True	\N
Avoda	True	Avodah
Avot	True	\N
Avos	True	Avot
ba'al	True	\N
baal	True	ba'al
bakashah	True	\N
bakasha	True	bakashah
Barekhu	True	\N
barchu	True	Barekhu
Barchu	True	Barekhu
barechu	True	Barekhu
Barechu	True	Barekhu
barekhu	True	Barekhu
barkhu	True	Barekhu
Barkhu	True	Barekhu
Barukh	True	\N
baruch	True	Barukh
Baruch	True	Barukh
barukh	True	Barukh
bateil	True	\N
batel	True	bateil
batteil	True	bateil
battel	True	bateil
Bavli	True	\N
bavli	True	Bavli
BeAv	False	\N
b'av	False	BeAv
b'Av	False	BeAv
B'av	False	BeAv
B'Av	False	BeAv
be'av	False	BeAv
be'Av	False	BeAv
Be'av	False	BeAv
Be'Av	False	BeAv
beAv	False	BeAv
bedieved	True	\N
b'dieved	True	bedieved
be'dieved	True	bedieved
bi'dieved	True	bedieved
bidieved	True	bedieved
bedikah	True	\N
b'dika	True	bedikah
b'dikah	True	bedikah
b'dikka	True	bedikah
b'dikkah	True	bedikah
bedika	True	bedikah
bedikka	True	bedikah
bedikkah	True	bedikah
bedikat	True	\N
b'dikas	True	bedikat
b'dikat	True	bedikat
b'dikkas	True	bedikat
b'dikkat	True	bedikat
bedikas	True	bedikat
bedikkas	True	bedikat
bedikkat	True	bedikat
be'ein	True	\N
b'ayn	True	be'ein
b'ein	True	be'ein
b'eyn	True	be'ein
be'ayn	True	be'ein
be'eyn	True	be'ein
bi'ayn	True	be'ein
bi'ein	True	be'ein
bi'eyn	True	be'ein
bein	True	\N
bayn	True	bein
Bein	True	\N
Bayn	True	Bein
beit	True	\N
bayt	True	beit
Beit Yosef	True	\N
BY	True	Beit Yosef
bekisnim	True	\N
b'kisnim	True	bekisnim
beliah	True	\N
beli'a	True	beliah
beli'ah	True	beliah
belia	True	beliah
beliya	True	beliah
beliyah	True	beliah
bli'a	True	beliah
blia	True	beliah
bliah	True	beliah
bliya	True	beliah
bliyah	True	beliah
beliat	True	\N
beli'at	True	beliat
beliyat	True	beliat
bli'at	True	beliat
bliyat	True	beliat
beliot	True	\N
beli'ot	True	beliot
beliyot	True	beliot
bli'ot	True	beliot
bliot	True	beliot
bliyot	True	beliot
beriot	True	\N
b'riyos	True	beriot
b'riyot	True	beriot
beriyos	True	beriot
beriyot	True	beriot
briyos	True	beriot
briyot	True	beriot
Berurah	True	\N
Berura	True	Berurah
Brura	True	Berurah
Brurah	True	Berurah
Berakhah	True	\N
Berachah	True	Berakhah
Berakha	True	Berakhah
Bracha	True	Berakhah
Brachah	True	Berakhah
Brakha	True	Berakhah
Brakhah	True	Berakhah
berakhah	True	\N
b'racha	True	berakhah
b'rachah	True	berakhah
b'rakha	True	berakhah
b'rakhah	True	berakhah
berachah	True	berakhah
berakha	True	berakhah
bracha	True	berakhah
brachah	True	berakhah
brakha	True	berakhah
brakhah	True	berakhah
berakhot	True	\N
b'rachot	True	berakhot
b'rakhot	True	berakhot
berachot	True	berakhot
brachot	True	berakhot
brakhot	True	berakhot
Berakhot	True	\N
B'rachot	True	Berakhot
B'rakhot	True	Berakhot
Berachot	True	Berakhot
Brachot	True	Berakhot
Brakhot	True	Berakhot
berabim	True	\N
b'rabbim	True	berabim
b'rabim	True	berabim
be'rabbim	True	berabim
be'rabim	True	berabim
berabbim	True	berabim
bi'rabbim	True	berabim
bi'rabim	True	berabim
birabbim	True	berabim
birabim	True	berabim
berov	True	\N
be'rov	True	berov
bi'rov	True	berov
besamim	True	\N
bisamim	True	besamim
besha'at	True	\N
b'sha'at	True	besha'at
b'shaat	True	besha'at
be'sha'at	True	besha'at
be'shaat	True	besha'at
beshaat	True	besha'at
bi'sha'at	True	besha'at
bi'shaat	True	besha'at
BeTammuz	True	\N
b'tammuz	True	BeTammuz
b'Tammuz	True	BeTammuz
B'tammuz	True	BeTammuz
B'Tammuz	True	BeTammuz
b'tamuz	True	BeTammuz
b'Tamuz	True	BeTammuz
B'tamuz	True	BeTammuz
B'Tamuz	True	BeTammuz
beTammuz	True	BeTammuz
betammuz	True	BeTammuz
Betammuz	True	BeTammuz
beTamuz	True	BeTammuz
betamuz	True	BeTammuz
Betamuz	True	BeTammuz
BeTamuz	True	BeTammuz
biTammuz	True	BeTammuz
bitammuz	True	BeTammuz
Bitammuz	True	BeTammuz
BiTammuz	True	BeTammuz
biTamuz	True	BeTammuz
bitamuz	True	BeTammuz
Bitamuz	True	BeTammuz
BiTamuz	True	BeTammuz
betzibur	True	\N
b'tzibbur	True	betzibur
b'tzibur	True	betzibur
be'tzibbur	True	betzibur
be'tzibur	True	betzibur
betzibbur	True	betzibur
Birkat	True	\N
bircat	True	Birkat
Bircat	True	Birkat
birkat	True	Birkat
bitul	True	\N
bittul	True	bitul
Biur	True	\N
Beiur	True	Biur
Beur	True	Biur
borei	True	\N
boray	True	borei
Borei	True	\N
Boray	True	Borei
Brit	False	\N
b'ris	False	Brit
B'ris	False	Brit
b'rit	False	Brit
B'rit	False	Brit
beris	False	Brit
Beris	False	Brit
berit	False	Brit
bris	False	Brit
Bris	False	Brit
brit	False	Brit
B''Shevat	True	\N
b'shevat	True	B''Shevat
B'shevat	True	B''Shevat
b'Shevat	True	B''Shevat
b'shvat	True	B''Shevat
B'shvat	True	B''Shevat
b'Shvat	True	B''Shevat
be'shevat	True	B''Shevat
Be'shevat	True	B''Shevat
be'Shevat	True	B''Shevat
Be'Shevat	True	B''Shevat
be'shvat	True	B''Shevat
Be'shvat	True	B''Shevat
be'Shvat	True	B''Shevat
Be'Shvat	True	B''Shevat
beshevat	True	B''Shevat
Beshevat	True	B''Shevat
beShevat	True	B''Shevat
BeShevat	True	B''Shevat
beshvat	True	B''Shevat
Beshvat	True	B''Shevat
beShvat	True	B''Shevat
BeShvat	True	B''Shevat
bi'shevat	True	B''Shevat
Bi'shevat	True	B''Shevat
bi'Shevat	True	B''Shevat
Bi'Shevat	True	B''Shevat
bi'shvat	True	B''Shevat
Bi'shvat	True	B''Shevat
bi'Shvat	True	B''Shevat
Bi'Shvat	True	B''Shevat
bishevat	True	B''Shevat
Bishevat	True	B''Shevat
biShevat	True	B''Shevat
BiShevat	True	B''Shevat
bishvat	True	B''Shevat
Bishvat	True	B''Shevat
biShvat	True	B''Shevat
BiShvat	True	B''Shevat
bShevat	True	B''Shevat
bShvat	True	B''Shevat
Chadash	True	\N
Khadash	True	Chadash
Chagim	True	\N
chaggim	True	Chagim
Chaggim	True	Chagim
chagim	True	Chagim
chameitz	True	\N
chametz	True	chameitz
Chanukah	False	\N
channuka	False	Chanukah
Channuka	False	Chanukah
channukah	False	Chanukah
Channukah	False	Chanukah
channukka	False	Chanukah
Channukka	False	Chanukah
channukkah	False	Chanukah
Channukkah	False	Chanukah
chanuka	False	Chanukah
Chanuka	False	Chanukah
chanukah	False	Chanukah
chanukka	False	Chanukah
Chanukka	False	Chanukah
chanukkah	False	Chanukah
Chanukkah	False	Chanukah
hannuka	False	Chanukah
Hannuka	False	Chanukah
hannukah	False	Chanukah
Hannukah	False	Chanukah
hannukka	False	Chanukah
Hannukka	False	Chanukah
hannukkah	False	Chanukah
Hannukkah	False	Chanukah
hanuka	False	Chanukah
Hanuka	False	Chanukah
hanukah	False	Chanukah
Hanukah	False	Chanukah
hanukka	False	Chanukah
Hanukka	False	Chanukah
hanukkah	False	Chanukah
Hanukkah	False	Chanukah
Chatam	True	\N
Chasam	True	Chatam
Chassam	True	Chatam
Chattam	True	Chatam
Hasam	True	Chatam
Hassam	True	Chatam
Hatam	True	Chatam
Hattam	True	Chatam
chatan	True	\N
chattan	True	chatan
Chayim	True	\N
Chayyim	True	Chayim
Hayim	True	Chayim
Hayyim	True	Chayim
chayim	True	\N
chayyim	True	chayim
hayim	True	chayim
hayyim	True	chayim
Chazal	True	\N
chazal	True	Chazal
chazzal	True	Chazal
Chazzal	True	Chazal
hazal	True	Chazal
Hazal	True	Chazal
hazzal	True	Chazal
Hazzal	True	Chazal
chesed	True	\N
chessed	True	chesed
hesed	True	chesed
hessed	True	chesed
chilul	True	\N
chillul	True	chilul
Chilul	True	\N
Chillul	True	Chilul
chinukh	True	\N
chinnuch	True	chinukh
chinnukh	True	chinukh
chinuch	True	chinukh
chiyuv	True	\N
chiyyuv	True	chiyuv
chodesh	True	\N
hodesh	True	chodesh
Chodesh	False	\N
Hodesh	False	Chodesh
Chol	True	\N
chol	True	Chol
Hol	True	Chol
cholah	True	\N
chola	True	cholah
cholla	True	cholah
chollah	True	cholah
choleh	True	\N
chole	True	choleh
cholle	True	choleh
cholleh	True	choleh
choshen	True	\N
Hoshen	True	choshen
chumra	True	\N
humra	True	chumra
chutz	True	\N
hutz	True	chutz
CM	True	\N
HM	True	CM
Chullin	True	\N
Chulin	True	Chullin
Hulin	True	Chullin
Hullin	True	Chullin
chumash	True	\N
chummash	True	chumash
humash	True	chumash
hummash	True	chumash
chuppah	True	\N
chupa	True	chuppah
chupah	True	chuppah
chuppa	True	chuppah
hupa	True	chuppah
hupah	True	chuppah
huppa	True	chuppah
huppah	True	chuppah
da'at	True	\N
daat	True	da'at
darkhei	True	\N
darchei	True	darkhei
Darkhei	True	\N
Darchei	True	Darkhei
De'ah	True	\N
De'a	True	De'ah
Dea	True	De'ah
Deah	True	De'ah
de'orayta	True	\N
d'oraita	True	de'orayta
d'oraitta	True	de'orayta
d'orayta	True	de'orayta
d'oraytta	True	de'orayta
de'oraita	True	de'orayta
de'oraitta	True	de'orayta
de'oraytta	True	de'orayta
di'oraita	True	de'orayta
di'oraitta	True	de'orayta
di'orayta	True	de'orayta
di'oraytta	True	de'orayta
derabanan	True	\N
d'rabanan	True	derabanan
d'rabbanan	True	derabanan
de'rabanan	True	derabanan
de'rabbanan	True	derabanan
derabbanan	True	derabanan
di'rabanan	True	derabanan
di'rabbanan	True	derabanan
DeRabbi	True	\N
D'Rabbi	True	DeRabbi
D'Rebbe	True	DeRabbi
De'Rabbi	True	DeRabbi
De'Rebbe	True	DeRabbi
DeRebbe	True	DeRabbi
derekh	True	\N
derech	True	derekh
devarim	True	\N
dvarim	True	devarim
Devarim	True	\N
Dvarim	True	Devarim
DeZimrah	True	\N
D'Zimra	True	DeZimrah
D'Zimrah	True	DeZimrah
De'Zimra	True	DeZimrah
De'Zimrah	True	DeZimrah
DeZimra	True	DeZimrah
dishvut	True	\N
di'shvus	True	dishvut
di'shvut	True	dishvut
dishvus	True	dishvut
Dodi	True	\N
doddi	True	Dodi
Doddi	True	Dodi
dodi	True	Dodi
Drasha	True	\N
d'rasha	True	Drasha
D'rasha	True	Drasha
derasha	True	Drasha
Derasha	True	Drasha
drasha	True	Drasha
Eden	True	\N
eden	True	Eden
eiden	True	Eden
Eiden	True	Eden
eidah	True	\N
ayda	True	eidah
aydah	True	eidah
edah	True	eidah
eida	True	eidah
eidim	True	\N
edim	True	eidim
Eikhah	True	\N
Aycha	True	Eikhah
Aychah	True	Eikhah
Aykha	True	Eikhah
Aykhah	True	Eikhah
echah	True	Eikhah
Echah	True	Eikhah
eichah	True	Eikhah
eikhah	True	Eikhah
ekhah	True	Eikhah
Ekhah	True	Eikhah
ein	True	\N
ayn	True	ein
eish	True	\N
aysh	True	eish
eiruv	True	\N
eruv	True	eiruv
Eiruvin	True	\N
Eruvin	True	Eiruvin
eino	True	\N
ayno	True	eino
emet	True	\N
emes	True	emet
Eretz	True	\N
eretz	True	Eretz
Erev	True	\N
erev	True	Erev
Esrei	True	\N
esray	True	Esrei
Esray	True	Esrei
esrei	True	Esrei
etrog	True	\N
esrog	True	etrog
eved	True	\N
evved	True	eved
fleishig	True	\N
flayshic	True	fleishig
flayshig	True	fleishig
flayshik	True	fleishig
fleishic	True	fleishig
fleishik	True	fleishig
fulfill	False	\N
fulfil	False	fulfill
Ge'onim	True	\N
ge'onim	True	Ge'onim
Geonim	True	Ge'onim
geonim	True	Ge'onim
gezeirah	True	\N
g'zeira	True	gezeirah
g'zeirah	True	gezeirah
g'zera	True	gezeirah
g'zerah	True	gezeirah
gezeira	True	gezeirah
gezera	True	gezeirah
gezerah	True	gezeirah
Gittin	True	\N
Gitin	True	Gittin
grama	True	\N
gerama	True	grama
geramah	True	grama
gramah	True	grama
HaAtzma'Ut	True	\N
ha'atzma'ut	True	HaAtzma'Ut
Ha'atzma'ut	True	HaAtzma'Ut
ha'Atzma'ut	True	HaAtzma'Ut
Ha'Atzma'ut	True	HaAtzma'Ut
ha'atzmaut	True	HaAtzma'Ut
Ha'atzmaut	True	HaAtzma'Ut
ha'Atzmaut	True	HaAtzma'Ut
Ha'Atzmaut	True	HaAtzma'Ut
haatzma'ut	True	HaAtzma'Ut
Haatzma'ut	True	HaAtzma'Ut
haAtzma'ut	True	HaAtzma'Ut
haatzmaut	True	HaAtzma'Ut
Haatzmaut	True	HaAtzma'Ut
haAtzmaut	True	HaAtzma'Ut
HaAtzmaut	True	HaAtzma'Ut
haba'ah	True	\N
haba	True	haba'ah
haba'a	True	haba'ah
habah	True	haba'ah
HaBat	True	\N
ha'bas	True	HaBat
ha'Bas	True	HaBat
Ha'bas	True	HaBat
Ha'Bas	True	HaBat
ha'bat	True	HaBat
ha'Bat	True	HaBat
Ha'bat	True	HaBat
Ha'Bat	True	HaBat
habas	True	HaBat
haBas	True	HaBat
Habas	True	HaBat
HaBas	True	HaBat
habat	True	HaBat
haBat	True	HaBat
Habat	True	HaBat
HaBen	True	\N
ha'ben	True	HaBen
ha'Ben	True	HaBen
Ha'ben	True	HaBen
Ha'Ben	True	HaBen
haben	True	HaBen
haBen	True	HaBen
Haben	True	HaBen
HaBeriot	True	\N
hab'rios	True	HaBeriot
haB'rios	True	HaBeriot
Hab'rios	True	HaBeriot
HaB'rios	True	HaBeriot
hab'riot	True	HaBeriot
haB'riot	True	HaBeriot
Hab'riot	True	HaBeriot
HaB'riot	True	HaBeriot
hab'riyos	True	HaBeriot
haB'riyos	True	HaBeriot
Hab'riyos	True	HaBeriot
HaB'riyos	True	HaBeriot
hab'riyot	True	HaBeriot
haB'riyot	True	HaBeriot
Hab'riyot	True	HaBeriot
HaB'riyot	True	HaBeriot
haberios	True	HaBeriot
haBerios	True	HaBeriot
Haberios	True	HaBeriot
HaBerios	True	HaBeriot
haberiot	True	HaBeriot
haBeriot	True	HaBeriot
Haberiot	True	HaBeriot
haberiyos	True	HaBeriot
haBeriyos	True	HaBeriot
Haberiyos	True	HaBeriot
HaBeriyos	True	HaBeriot
haberiyot	True	HaBeriot
haBeriyot	True	HaBeriot
Haberiyot	True	HaBeriot
HaBeriyot	True	HaBeriot
HaChamah	True	\N
hachama	True	HaChamah
Hachama	True	HaChamah
HaChama	True	HaChamah
hachamah	True	HaChamah
Hachamah	True	HaChamah
HaChayim	True	\N
HaChayyim	True	HaChayim
HaHayim	True	HaChayim
HaHayyim	True	HaChayim
HaChodesh	True	\N
hachodesh	True	HaChodesh
haChodesh	True	HaChodesh
Hachodesh	True	HaChodesh
hada'at	True	\N
hadaat	True	hada'at
hadechak	True	\N
hadchak	True	hadechak
hadekhak	True	hadechak
hadkhak	True	hadechak
HaDechak	True	\N
Hadchak	True	HaDechak
haDechak	True	HaDechak
Hadechak	True	HaDechak
Hadekhak	True	HaDechak
haDekhak	True	HaDechak
Hadkhak	True	HaDechak
HaEish	True	\N
ha'aysh	True	HaEish
ha'Aysh	True	HaEish
Ha'aysh	True	HaEish
Ha'Aysh	True	HaEish
ha'eish	True	HaEish
ha'Eish	True	HaEish
Ha'eish	True	HaEish
Ha'Eish	True	HaEish
haEish	True	HaEish
HaEzer	True	\N
Ha'ezer	True	HaEzer
Ha'Ezer	True	HaEzer
haEzer	True	HaEzer
Haezer	True	HaEzer
haftarah	True	\N
haftorah	True	haftarah
HaGafen	True	\N
hagafen	True	HaGafen
haGafen	True	HaGafen
Hagafen	True	HaGafen
hagefen	True	HaGafen
haGefen	True	HaGafen
Hagefen	True	HaGafen
HaGefen	True	HaGafen
hagbahah	True	\N
hagba	True	hagbahah
hagbah	True	hagbahah
hagbaha	True	hagbahah
Haggadah	True	\N
hagada	True	Haggadah
Hagada	True	Haggadah
hagadah	True	Haggadah
Hagadah	True	Haggadah
haggada	True	Haggadah
Haggada	True	Haggadah
haggadah	True	Haggadah
haggadot	True	\N
hagados	True	haggadot
Hagados	True	haggadot
hagadot	True	haggadot
Hagadot	True	haggadot
haggados	True	haggadot
Haggados	True	haggadot
Haggadot	True	haggadot
HaGomeil	True	\N
hagomeil	True	HaGomeil
haGomeil	True	HaGomeil
Hagomeil	True	HaGomeil
hagomel	True	HaGomeil
haGomel	True	HaGomeil
Hagomel	True	HaGomeil
HaGomel	True	HaGomeil
HaKadosh	True	\N
hakaddosh	True	HaKadosh
Hakaddosh	True	HaKadosh
haKaddosh	True	HaKadosh
HaKaddosh	True	HaKadosh
hakadosh	True	HaKadosh
haKadosh	True	HaKadosh
Hakadosh	True	HaKadosh
Hakafot	True	\N
hakafos	True	Hakafot
Hakafos	True	Hakafot
hakafot	True	Hakafot
hakhanah	True	\N
hachana	True	hakhanah
hachanah	True	hakhanah
hakhana	True	hakhanah
HaKokhavim	True	\N
hacochavim	True	HaKokhavim
haCochavim	True	HaKokhavim
HaCochavim	True	HaKokhavim
hacokhavim	True	HaKokhavim
haCokhavim	True	HaKokhavim
HaCokhavim	True	HaKokhavim
hakochavim	True	HaKokhavim
Hakochavim	True	HaKokhavim
HaKochavim	True	HaKokhavim
hakokhavim	True	HaKokhavim
Hakokhavim	True	HaKokhavim
Halakha	True	\N
Halacha	True	Halakha
Halachah	True	Halakha
Halakhah	True	Halakha
halakha	True	\N
halacha	True	halakha
halachah	True	halakha
halakhah	True	halakha
halakhic	False	\N
Halachic	False	halakhic
halachic	False	halakhic
Halachik	False	halakhic
halachik	False	halakhic
Halakhic	False	halakhic
Halakhik	False	halakhic
halakhik	False	halakhic
halakhically	False	\N
Halachically	False	halakhically
halachically	False	halakhically
Halakhically	False	halakhically
halakhot	True	\N
halachot	True	halakhot
Hallel	False	\N
hallel	False	Hallel
HaMafseket	True	\N
hamafsekes	True	HaMafseket
haMafsekes	True	HaMafseket
Hamafsekes	True	HaMafseket
HaMafsekes	True	HaMafseket
hamafseket	True	HaMafseket
haMafseket	True	HaMafseket
Hamafseket	True	HaMafseket
HaMavdil	True	\N
hamavdil	True	HaMavdil
haMavdil	True	HaMavdil
Hamavdil	True	HaMavdil
HaMazon	True	\N
hamazon	True	HaMazon
haMazon	True	HaMazon
Hamazon	True	HaMazon
HaMikdash	True	\N
ha'mikdash	True	HaMikdash
ha'Mikdash	True	HaMikdash
Ha'mikdash	True	HaMikdash
Ha'Mikdash	True	HaMikdash
ha'miqdash	True	HaMikdash
ha'Miqdash	True	HaMikdash
Ha'miqdash	True	HaMikdash
Ha'Miqdash	True	HaMikdash
hamikdash	True	HaMikdash
haMikdash	True	HaMikdash
Hamikdash	True	HaMikdash
hamiqdash	True	HaMikdash
haMiqdash	True	HaMikdash
Hamiqdash	True	HaMikdash
HaMiqdash	True	HaMikdash
hamikra	True	\N
ha'mikra	True	hamikra
ha'miqra	True	hamikra
hamiqra	True	hamikra
HaMinchah	True	\N
ha'mincha	True	HaMinchah
Ha'mincha	True	HaMinchah
ha'Mincha	True	HaMinchah
Ha'Mincha	True	HaMinchah
ha'minchah	True	HaMinchah
Ha'minchah	True	HaMinchah
ha'Minchah	True	HaMinchah
Ha'Minchah	True	HaMinchah
hamincha	True	HaMinchah
Hamincha	True	HaMinchah
haMincha	True	HaMinchah
HaMincha	True	HaMinchah
haminchah	True	HaMinchah
Haminchah	True	HaMinchah
haMinchah	True	HaMinchah
HaMitzvah	True	\N
hamitzva	True	HaMitzvah
haMitzva	True	HaMitzvah
Hamitzva	True	HaMitzvah
HaMitzva	True	HaMitzvah
hamitzvah	True	HaMitzvah
haMitzvah	True	HaMitzvah
Hamitzvah	True	HaMitzvah
HaMitzvot	True	\N
hamitzvos	True	HaMitzvot
haMitzvos	True	HaMitzvot
Hamitzvos	True	HaMitzvot
HaMitzvos	True	HaMitzvot
hamitzvot	True	HaMitzvot
haMitzvot	True	HaMitzvot
Hamitzvot	True	HaMitzvot
HaMotzi	True	\N
ha'motzi	True	HaMotzi
Ha'motzi	True	HaMotzi
hamotzi	True	HaMotzi
Hamotzi	True	HaMotzi
haMotzi	True	HaMotzi
hana'ah	True	\N
hana'a	True	hana'ah
hanaa	True	hana'ah
hanaah	True	hana'ah
hanachah	True	\N
hanacha	True	hanachah
hanakha	True	hanachah
hanakhah	True	hanachah
HaNeitz	True	\N
haneitz	True	HaNeitz
Haneitz	True	HaNeitz
hanetz	True	HaNeitz
Hanetz	True	HaNeitz
HaNetz	True	HaNeitz
Neitz	True	HaNeitz
neitz	True	HaNeitz
Netz	True	HaNeitz
netz	True	HaNeitz
HaNisim	True	\N
hanisim	True	HaNisim
haNisim	True	HaNisim
Hanisim	True	HaNisim
hanissim	True	HaNisim
haNissim	True	HaNisim
Hanissim	True	HaNisim
HaNissim	True	HaNisim
HaOmer	True	\N
ha'omer	True	HaOmer
ha'Omer	True	HaOmer
Ha'omer	True	HaOmer
Ha'Omer	True	HaOmer
haOmer	True	HaOmer
haposkim	True	\N
ha'poskim	True	haposkim
HaPoskim	True	\N
Ha'Poskim	True	HaPoskim
ha'Poskim	True	HaPoskim
haPoskim	True	HaPoskim
Haposkim	True	HaPoskim
HaRabim	True	\N
harabbim	True	HaRabim
haRabbim	True	HaRabim
Harabbim	True	HaRabim
HaRabbim	True	HaRabim
harabim	True	HaRabim
haRabim	True	HaRabim
Harabim	True	HaRabim
HaShachar	True	\N
ha'shevach	True	HaShachar
ha'Shevach	True	HaShachar
Ha'shevach	True	HaShachar
Ha'Shevach	True	HaShachar
ha'shevakh	True	HaShachar
ha'Shevakh	True	HaShachar
Ha'shevakh	True	HaShachar
Ha'Shevakh	True	HaShachar
hashevach	True	HaShachar
haShevach	True	HaShachar
Hashevach	True	HaShachar
hashevakh	True	HaShachar
haShevakh	True	HaShachar
Hashevakh	True	HaShachar
HaShevakh	True	HaShachar
HaShanah	False	\N
hashana	False	HaShanah
haShana	False	HaShanah
Hashana	False	HaShanah
HaShana	False	HaShanah
hashanah	False	HaShanah
haShanah	False	HaShanah
Hashanah	False	HaShanah
HaShem	False	\N
Hashem	False	HaShem
haShem	False	HaShem
HaShemashot	True	\N
hashemashot	True	HaShemashot
haShemashot	True	HaShemashot
Hashemashot	True	HaShemashot
hashmashot	True	HaShemashot
haShmashot	True	HaShemashot
Hashmashot	True	HaShemashot
HaShmashot	True	HaShemashot
HaShulchan	True	\N
Hashulchan	True	HaShulchan
haShulchan	True	HaShulchan
HaShulkhan	True	HaShulchan
hashulkhan	True	HaShulchan
Hashulkhan	True	HaShulchan
HaTorah	True	\N
ha'Torah	True	HaTorah
Ha'Torah	True	HaTorah
ha'torah	True	HaTorah
hatorah	True	HaTorah
HaTzibur	True	\N
hatzibbur	True	HaTzibur
haTzibbur	True	HaTzibur
Hatzibbur	True	HaTzibur
HaTzibbur	True	HaTzibur
hatzibur	True	HaTzibur
Hatzibur	True	HaTzibur
haTzibur	True	HaTzibur
Havdalah	False	\N
havdala	False	Havdalah
Havdala	False	Havdalah
havdalah	False	Havdalah
HaZikaron	True	\N
ha'zikaron	True	HaZikaron
ha'Zikaron	True	HaZikaron
Ha'zikaron	True	HaZikaron
Ha'Zikaron	True	HaZikaron
ha'zikkaron	True	HaZikaron
ha'Zikkaron	True	HaZikaron
Ha'zikkaron	True	HaZikaron
Ha'Zikkaron	True	HaZikaron
hazikaron	True	HaZikaron
haZikaron	True	HaZikaron
Hazikaron	True	HaZikaron
hazikkaron	True	HaZikaron
haZikkaron	True	HaZikaron
Hazikkaron	True	HaZikaron
HaZikkaron	True	HaZikaron
hefseik	True	\N
hefsek	True	hefseik
hephseik	True	hefseik
hephsek	True	hefseik
hekhsher	True	\N
hechsheir	True	hekhsher
hechsher	True	hekhsher
hekhsheir	True	hekhsher
heter	True	\N
hetter	True	heter
heteirim	True	\N
heterim	True	heteirim
hilkhot	True	\N
hilchot	True	hilkhot
hoda'ah	True	\N
hoda'a	True	hoda'ah
hodaa	True	hoda'ah
hodaah	True	hoda'ah
Hoshanah	False	\N
hoshana	False	Hoshanah
Hoshana	False	Hoshanah
hoshanah	False	Hoshanah
Hoshanot	True	\N
hoshanos	True	Hoshanot
Hoshanos	True	Hoshanot
hoshanot	True	Hoshanot
I	False	\N
i	False	I
Iggrot	True	\N
Igrot	True	Iggrot
Iggrot Moshe	True	\N
IM	True	Iggrot Moshe
iruy	True	\N
irui	True	iruy
ishah	True	\N
isha	True	ishah
Ishah	True	\N
Isha	True	Ishah
issur	True	\N
isur	True	issur
issurei	True	\N
issurrei	True	issurei
isurei	True	issurei
isurrei	True	issurei
issurim	True	\N
issurrim	True	issurim
isurim	True	issurim
isurrim	True	issurim
Iyar	False	\N
iyar	False	Iyar
iyyar	False	Iyar
Iyyar	False	Iyar
Kabbalah	True	\N
kabala	True	Kabbalah
Kabala	True	Kabbalah
kabalah	True	Kabbalah
Kabalah	True	Kabbalah
kabbala	True	Kabbalah
Kabbala	True	Kabbalah
kabbalah	True	Kabbalah
Kabbalat	True	\N
kabalas	True	Kabbalat
Kabalas	True	Kabbalat
kabalat	True	Kabbalat
Kabalat	True	Kabbalat
kabbalas	True	Kabbalat
Kabbalas	True	Kabbalat
kabbalat	True	Kabbalat
Kaddish	False	\N
kaddish	False	Kaddish
kadish	False	Kaddish
Kadish	False	Kaddish
kadosh	True	\N
kaddosh	True	kadosh
kahal	True	\N
kahhal	True	kahal
kehal	True	kahal
kehhal	True	kahal
kallah	True	\N
kala	True	kallah
kalah	True	kallah
kalla	True	kallah
kamatz	True	\N
kammatz	True	kamatz
kaparot	True	\N
kaparos	True	kaparot
Kaparos	True	kaparot
Kaparot	True	kaparot
kapparos	True	kaparot
Kapparos	True	kaparot
kapparot	True	kaparot
Kapparot	True	kaparot
kareit	True	\N
careis	True	kareit
careit	True	kareit
caret	True	kareit
kareis	True	kareit
kares	True	kareit
karet	True	kareit
katan	True	\N
kattan	True	katan
Katan	False	\N
Kattan	False	Katan
kavanah	True	\N
kavana	True	kavanah
kavanna	True	kavanah
kavannah	True	kavanah
kavvana	True	kavanah
kavvanah	True	kavanah
kebeitzah	True	\N
k'baytza	True	kebeitzah
k'beitza	True	kebeitzah
k'beitzah	True	kebeitzah
k'betza	True	kebeitzah
k'betzah	True	kebeitzah
kebaytza	True	kebeitzah
kebeitza	True	kebeitzah
kebetza	True	kebeitzah
kebetzah	True	kebeitzah
kebeitzim	True	\N
k'baytzim	True	kebeitzim
k'beitzim	True	kebeitzim
k'betzim	True	kebeitzim
kebaytzim	True	kebeitzim
kebetzim	True	kebeitzim
kedushah	True	\N
k'dusha	True	kedushah
k'dushah	True	kedushah
kdusha	True	kedushah
kdushah	True	kedushah
kedusha	True	kedushah
kedushot	True	\N
k'dushos	True	kedushot
k'dushot	True	kedushot
kdushos	True	kedushot
kdushot	True	kedushot
kedushos	True	kedushot
keilim	True	\N
kelim	True	keilim
keli	True	\N
kli	True	keli
kenas	True	\N
knas	True	kenas
Keneset	True	\N
Kenesset	True	Keneset
keneset	True	\N
kenesset	True	keneset
keriah	True	\N
k'riya	True	keriah
k'riyah	True	keriah
keri'ah	True	keriah
keriyah	True	keriah
kri'ah	True	keriah
kriah	True	keriah
kriyah	True	keriah
keriat	True	\N
k'riyat	True	keriat
keri'at	True	keriat
keriyat	True	keriat
kri'at	True	keriat
kriat	True	keriat
kriyat	True	keriat
keviat	True	\N
k'vias	True	keviat
k'viat	True	keviat
kevias	True	keviat
kvias	True	keviat
kviat	True	keviat
kezayit	True	\N
k'zayis	True	kezayit
k'zayit	True	kezayit
kazayis	True	kezayit
kazayit	True	kezayit
kezayis	True	kezayit
kezeitim	True	\N
k'zaytim	True	kezeitim
k'zeitim	True	kezeitim
k'zetim	True	kezeitim
kazaytim	True	kezeitim
kazeitim	True	kezeitim
kazetim	True	kezeitim
kezaytim	True	kezeitim
kezetim	True	kezeitim
Kiddush	False	\N
kiddush	False	Kiddush
kidush	False	Kiddush
Kidush	False	Kiddush
kiddushin	True	\N
kidushin	True	kiddushin
Kiddushin	True	\N
Kidushin	True	Kiddushin
kinot	True	\N
kinos	True	kinot
Kippur	True	\N
kippur	True	Kippur
kipur	True	Kippur
Kipur	True	Kippur
kitniyot	True	\N
kitniyos	True	kitniyot
kittel	True	\N
kitel	True	kittel
kiyum	True	\N
kiyyum	True	kiyum
Kohanim	False	\N
cohanim	False	Kohanim
Cohanim	False	Kohanim
kohanim	False	Kohanim
kohen	True	\N
cohein	True	kohen
cohen	True	kohen
kohein	True	kohen
kokhavim	True	\N
cochavim	True	kokhavim
cokhavim	True	kokhavim
kochavim	True	kokhavim
kol	True	\N
koll	True	kol
Kol	True	\N
Koll	True	Kol
Koleinu	True	\N
koleinu	True	Koleinu
kolleinu	True	Koleinu
Kolleinu	True	Koleinu
korban	True	\N
qorban	True	korban
Korban	True	\N
Qorban	True	Korban
korei	True	\N
koray	True	korei
kore	True	korei
koreh	True	korei
kovei'a	True	\N
kovei'ah	True	kovei'a
koveiya	True	kovei'a
koveiyah	True	kovei'a
koveya	True	kovei'a
koveyah	True	kovei'a
kula	True	\N
kulah	True	kula
kulla	True	kula
kullah	True	kula
kulot	True	\N
kulos	True	kulot
le'akum	True	\N
l'akkum	True	le'akum
l'akum	True	le'akum
le'akkum	True	le'akum
leakum	True	le'akum
lehachmir	True	\N
l'hachmir	True	lehachmir
l'hakhmir	True	lehachmir
le'hachmir	True	lehachmir
le'hakhmir	True	lehachmir
lehakhmir	True	lehachmir
legoy	True	\N
l'goy	True	legoy
lehakeil	True	\N
l'hakeil	True	lehakeil
l'hakel	True	lehakeil
le'hakeil	True	lehakeil
le'hakel	True	lehakeil
lehakel	True	lehakeil
leih	True	\N
lay	True	leih
lein	True	\N
layn	True	lein
leined	False	\N
layned	False	leined
leining	False	\N
layning	False	leining
Lekha	True	\N
lecha	True	Lekha
Lecha	True	Lekha
lechah	True	Lekha
Lechah	True	Lekha
lekha	True	Lekha
lekhah	True	Lekha
Lekhah	True	Lekha
lekhatchilah	True	\N
l'chatchila	True	lekhatchilah
l'chatchilah	True	lekhatchilah
l'chatkhila	True	lekhatchilah
l'chatkhilah	True	lekhatchilah
l'hatchila	True	lekhatchilah
l'hatchilah	True	lekhatchilah
l'hatkhila	True	lekhatchilah
l'hatkhilah	True	lekhatchilah
l'khatchila	True	lekhatchilah
l'khatchilah	True	lekhatchilah
l'khatkhila	True	lekhatchilah
l'khatkhilah	True	lekhatchilah
lechatchila	True	lekhatchilah
lechatchilah	True	lekhatchilah
lechatkhila	True	lekhatchilah
lechatkhilah	True	lekhatchilah
lehatchila	True	lekhatchilah
lehatchilah	True	lekhatchilah
lehatkhila	True	lekhatchilah
lehatkhilah	True	lekhatchilah
lekhatkhila	True	lekhatchilah
lekhatkhilah	True	lekhatchilah
li'chatchila	True	lekhatchilah
li'chatchilah	True	lekhatchilah
li'chatkhila	True	lekhatchilah
li'chatkhilah	True	lekhatchilah
li'hatchila	True	lekhatchilah
li'hatchilah	True	lekhatchilah
li'hatkhila	True	lekhatchilah
li'hatkhilah	True	lekhatchilah
li'khatchila	True	lekhatchilah
li'khatchilah	True	lekhatchilah
li'khatkhila	True	lekhatchilah
li'khatkhilah	True	lekhatchilah
lichatchila	True	lekhatchilah
lichatchilah	True	lekhatchilah
lichatkhila	True	lekhatchilah
lichatkhilah	True	lekhatchilah
lihatchila	True	lekhatchilah
lihatchilah	True	lekhatchilah
lihatkhila	True	lekhatchilah
lihatkhilah	True	lekhatchilah
likhatchila	True	lekhatchilah
likhatchilah	True	lekhatchilah
likhatkhila	True	lekhatchilah
likhatkhilah	True	lekhatchilah
lema'aseh	True	\N
l'ma'ase	True	lema'aseh
l'ma'aseh	True	lema'aseh
l'maase	True	lema'aseh
l'maaseh	True	lema'aseh
le'ma'ase	True	lema'aseh
le'ma'aseh	True	lema'aseh
le'maase	True	lema'aseh
le'maaseh	True	lema'aseh
le'mayse	True	lema'aseh
le'mayseh	True	lema'aseh
lema'ase	True	lema'aseh
li'maase	True	lema'aseh
li'maaseh	True	lema'aseh
li'mayse	True	lema'aseh
li'mayseh	True	lema'aseh
lima'ase	True	lema'aseh
lima'aseh	True	lema'aseh
limaase	True	lema'aseh
limaaseh	True	lema'aseh
limayse	True	lema'aseh
limayseh	True	lema'aseh
LeMoshe	True	\N
l'moshe	True	LeMoshe
l'Moshe	True	LeMoshe
L'moshe	True	LeMoshe
L'Moshe	True	LeMoshe
le'moshe	True	LeMoshe
le'Moshe	True	LeMoshe
Le'moshe	True	LeMoshe
Le'Moshe	True	LeMoshe
lemoshe	True	LeMoshe
leMoshe	True	LeMoshe
li'moshe	True	LeMoshe
li'Moshe	True	LeMoshe
Li'moshe	True	LeMoshe
Li'Moshe	True	LeMoshe
lenokhri	True	\N
l'nochri	True	lenokhri
l'nokhri	True	lenokhri
le'nochri	True	lenokhri
le'nokhri	True	lenokhri
lenochri	True	lenokhri
li'nochri	True	lenokhri
li'nokhri	True	lenokhri
levatalah	True	\N
l'vatala	True	levatalah
l'vatalah	True	levatalah
le'vatala	True	levatalah
le'vatalah	True	levatalah
levatala	True	levatalah
li'vatala	True	levatalah
li'vatalah	True	levatalah
livatala	True	levatalah
livatalah	True	levatalah
lulav	True	\N
lullav	True	lulav
Ma'ariv	False	\N
Maariv	False	Ma'ariv
maariv	False	Ma'ariv
ma'aseh	True	\N
ma'ase	True	ma'aseh
maase	True	ma'aseh
maaseh	True	ma'aseh
mayse	True	ma'aseh
mayseh	True	ma'aseh
ma'aser	True	\N
maaser	True	ma'aser
mayser	True	ma'aser
ma'asrot	False	\N
ma'asros	False	ma'asrot
maasros	False	ma'asrot
maasrot	False	ma'asrot
maysros	False	ma'asrot
maysrot	False	ma'asrot
machloket	True	\N
machaloket	True	machloket
machaloqet	True	machloket
machloqet	True	machloket
makhaloket	True	machloket
makhaloqet	True	machloket
makhloket	True	machloket
makhloqet	True	machloket
machmir	True	\N
makhmir	True	machmir
Mafseket	True	\N
mafsekes	True	Mafseket
Mafsekes	True	Mafseket
mafseket	True	Mafseket
mafsik	True	\N
maphsik	True	mafsik
maftir	True	\N
maphtir	True	maftir
Malkeinu	True	\N
Malkenu	True	Malkeinu
maror	True	\N
marror	True	maror
matzah	True	\N
matza	True	matzah
matzo	True	matzah
matzoh	True	matzah
mazon	True	\N
mazzon	True	mazon
me'akeiv	True	\N
me'aceiv	True	me'akeiv
me'acev	True	me'akeiv
me'akev	True	me'akeiv
mechaleil	True	\N
mechalel	True	mechaleil
mekhaleil	True	mechaleil
mekhalel	True	mechaleil
mi'chaleil	True	mechaleil
mi'chalel	True	mechaleil
mi'khaleil	True	mechaleil
mi'khalel	True	mechaleil
michaleil	True	mechaleil
michalel	True	mechaleil
mikhaleil	True	mechaleil
mikhalel	True	mechaleil
Mechaleil	True	\N
Mechalel	True	Mechaleil
Mekhaleil	True	Mechaleil
Mekhalel	True	Mechaleil
Mi'chaleil	True	Mechaleil
Mi'chalel	True	Mechaleil
Mi'khaleil	True	Mechaleil
Mi'khalel	True	Mechaleil
Michaleil	True	Mechaleil
Michalel	True	Mechaleil
Mikhaleil	True	Mechaleil
Mikhalel	True	Mechaleil
megillah	True	\N
megila	True	megillah
megilah	True	megillah
megilla	True	megillah
Megillah	True	\N
Megila	True	Megillah
Megilah	True	Megillah
Megilla	True	Megillah
megillot	True	\N
megillos	True	megillot
megilos	True	megillot
megilot	True	megillot
melakhah	True	\N
melacha	True	melakhah
melachah	True	melakhah
melakha	True	melakhah
Me'orei	True	\N
m'oray	True	Me'orei
M'oray	True	Me'orei
m'orei	True	Me'orei
M'orei	True	Me'orei
me'oray	True	Me'orei
Me'oray	True	Me'orei
me'orei	True	Me'orei
meoray	True	Me'orei
Meoray	True	Me'orei
meorei	True	Me'orei
Meorei	True	Me'orei
mesadeir	True	\N
mesader	True	mesadeir
mesorah	True	\N
mesora	True	mesorah
mesorra	True	mesorah
mesorrah	True	mesorah
messora	True	mesorah
messorah	True	mesorah
Mesorah	True	\N
Mesora	True	Mesorah
Mesorra	True	Mesorah
Mesorrah	True	Mesorah
Messora	True	Mesorah
Messorah	True	Mesorah
mezonot	True	\N
mezonos	True	mezonot
Mezonot	True	\N
Mezonos	True	Mezonot
Midrash	False	\N
medrash	False	Midrash
Medrash	False	Midrash
medrish	False	Midrash
Medrish	False	Midrash
midrash	False	Midrash
mikveh	True	\N
mikva	True	mikveh
mikvah	True	mikveh
mikve	True	mikveh
milkhig	True	\N
milchic	True	milkhig
milchig	True	milkhig
milchik	True	milkhig
milkhic	True	milkhig
milkhik	True	milkhig
Mincha	False	\N
mincha	False	Mincha
minchah	False	Mincha
minha	False	Mincha
Minei	True	\N
minay	True	Minei
Minay	True	Minei
minei	True	Minei
Minhag	False	\N
minhag	False	Minhag
Mishkah	True	\N
mishkan	True	Mishkah
Mishnah	True	\N
Mishna	True	Mishnah
Mishne	True	Mishnah
Mishneh	True	Mishnah
Mishnah Berurah	True	\N
MB	True	Mishnah Berurah
MiSinai	True	\N
mesinai	True	MiSinai
meSinai	True	MiSinai
Mesinai	True	MiSinai
MeSinai	True	MiSinai
mi'sinai	True	MiSinai
mi'Sinai	True	MiSinai
Mi'sinai	True	MiSinai
Mi'Sinai	True	MiSinai
misinai	True	MiSinai
miSinai	True	MiSinai
Misinai	True	MiSinai
mitzvah	False	\N
mitzva	False	mitzvah
mitza'eir	True	\N
mitzta'er	True	mitza'eir
mitztaeir	True	mitza'eir
mitztaer	True	mitza'eir
mitzvat	True	\N
mitzvas	True	mitzvat
mitzvot	True	\N
mitzvos	True	mitzvot
Mo'adim	True	\N
mo'adim	True	Mo'adim
moadim	True	Mo'adim
Moadim	True	Mo'adim
Mo'ed	True	\N
mo'ed	True	Mo'ed
moed	True	Mo'ed
Moed	True	Mo'ed
Moshe	False	\N
moshe	False	Moshe
Mosheh	False	Moshe
mosheh	False	Moshe
Motzei	False	\N
Motzaei	False	Motzei
muktzeh	True	\N
muktza	True	muktzeh
muktzah	True	muktzeh
muktze	True	muktzeh
Musaf	False	\N
musaf	False	Musaf
mussaf	False	Musaf
Mussaf	False	Musaf
mutar	True	\N
muttar	True	mutar
Natan	True	\N
Nasan	True	Natan
Nassan	True	Natan
Nattan	True	Natan
nefesh	True	\N
nephesh	True	nefesh
negiah	True	\N
negia	True	negiah
Ne'ilah	True	\N
ne'ila	True	Ne'ilah
Ne'ila	True	Ne'ilah
ne'ilah	True	Ne'ilah
neila	True	Ne'ilah
Neila	True	Ne'ilah
neilah	True	Ne'ilah
Neilah	True	Ne'ilah
ni'ila	True	Ne'ilah
Ni'ila	True	Ne'ilah
ni'ilah	True	Ne'ilah
Ni'ilah	True	Ne'ilah
niila	True	Ne'ilah
Niila	True	Ne'ilah
niilah	True	Ne'ilah
Niilah	True	Ne'ilah
neis	True	\N
nes	True	neis
neshamah	True	\N
neshama	True	neshamah
nicha	True	\N
nichah	True	nicha
nikha	True	nicha
nikhah	True	nicha
niddah	True	\N
nida	True	niddah
nidah	True	niddah
nidda	True	niddah
Niddah	True	\N
Nida	True	Niddah
Nidah	True	Niddah
Nidda	True	Niddah
Nishmat	True	\N
nishmas	True	Nishmat
Nishmas	True	Nishmat
nishmat	True	Nishmat
nisuin	True	\N
nissu'in	True	nisuin
nissuin	True	nisuin
nisu'in	True	nisuin
nokhri	True	\N
nochri	True	nokhri
noy	True	\N
noi	True	noy
nusach	True	\N
nusakh	True	nusach
nussach	True	nusach
nussakh	True	nusach
OC	True	\N
OH	True	OC
onah	True	\N
aguda	True	agudah
siyyum	True	\N
siyum	True	siyyum
Re	False	\N
Regarding	False	Re
asdfgh	False	\N
BiDieved	True	bedieved
ona	True	onah
onein	True	\N
onen	True	onein
omer	True	\N
ommer	True	omer
Omer	True	\N
Ommer	True	Omer
Orach	True	\N
Orah	True	Orach
Orakh	True	Orach
oveid	True	\N
oved	True	oveid
ovedei	True	\N
ovdei	True	ovedei
ovedim	True	\N
ovdim	True	ovedim
pagum	True	\N
p'gum	True	pagum
parashah	True	\N
parasha	True	parashah
parsha	True	parashah
parshah	True	parashah
pareve	True	\N
parve	True	pareve
pasuk	True	\N
pasuq	True	pasuk
Pasuk	True	\N
Pasuq	True	Pasuk
pat	True	\N
pas	True	pat
perek	True	\N
pereq	True	perek
Perek	True	\N
Pereq	True	Perek
pesak	True	\N
p'sak	True	pesak
psak	True	pesak
Pesak	True	\N
P'sak	True	Pesak
Psak	True	Pesak
Pesach	True	\N
pesach	True	Pesach
pesakh	True	Pesach
Pesakh	True	Pesach
Pesachim	True	\N
p'sachim	True	Pesachim
P'sachim	True	Pesachim
p'sahim	True	Pesachim
P'sahim	True	Pesachim
p'sakhim	True	Pesachim
P'sakhim	True	Pesachim
pesachim	True	Pesachim
pesahim	True	Pesachim
Pesahim	True	Pesachim
pesakhim	True	Pesachim
Pesakhim	True	Pesachim
psachim	True	Pesachim
Psachim	True	Pesachim
psahim	True	Pesachim
Psahim	True	Pesachim
psakhim	True	Pesachim
Psakhim	True	Pesachim
Pesukei	True	\N
p'sukai	True	Pesukei
P'sukai	True	Pesukei
p'sukei	True	Pesukei
P'sukei	True	Pesukei
pesukai	True	Pesukei
Pesukai	True	Pesukei
pesukei	True	Pesukei
pisukai	True	Pesukei
Pisukai	True	Pesukei
pisukei	True	Pesukei
Pisukei	True	Pesukei
psukai	True	Pesukei
Psukai	True	Pesukei
psukei	True	Pesukei
Psukei	True	Pesukei
pesukim	True	\N
p'sukim	True	pesukim
psukim	True	pesukim
Pidyon	True	\N
pidyon	True	Pidyon
pidyyon	True	Pidyon
Pidyyon	True	Pidyon
pikuach	True	\N
pekuach	True	pikuach
Pitchei	True	\N
Pischay	True	Pitchei
Pische	True	Pitchei
Pischei	True	Pitchei
Pishay	True	Pitchei
Pishei	True	Pitchei
Pitchay	True	Pitchei
Pithay	True	Pitchei
Pithei	True	Pitchei
Pirkei	True	\N
Pirkai	True	Pirkei
Pirkay	True	Pirkei
Plag	True	\N
plag	True	Plag
posek	False	\N
poseik	False	posek
Purim	False	\N
purim	False	Purim
purrim	False	Purim
Purrim	False	Purim
Rabbah	False	\N
raba	False	Rabbah
Raba	False	Rabbah
rabah	False	Rabbah
Rabah	False	Rabbah
rabba	False	Rabbah
Rabba	False	Rabbah
rabbah	False	Rabbah
Rabbi	False	\N
Rabi	False	Rabbi
rabim	True	\N
rabbim	True	rabim
refuah	True	\N
r'fua	True	refuah
r'fuah	True	refuah
refua	True	refuah
rfua	True	refuah
rfuah	True	refuah
Reish	True	\N
reish	True	Reish
resh	True	Reish
Resh	True	Reish
reisha	True	\N
reishah	True	reisha
Retzeih	True	\N
retzay	True	Retzeih
Retzay	True	Retzeih
retzei	True	Retzeih
Retzei	True	Retzeih
retzeih	True	Retzeih
Rishonim	True	\N
rishonim	True	Rishonim
Ritva	True	\N
ritva	True	Ritva
ritvah	True	Ritva
Ritvah	True	Ritva
rosh'titlecase	False	\N
safeik	True	\N
safek	True	safeik
sefer	True	\N
sefeir	True	sefer
Sefer	True	\N
Sefeir	True	Sefer
sefarim	True	\N
seforim	True	sefarim
Sefirat	True	\N
S'firas	True	Sefirat
S'firat	True	Sefirat
Sefiras	True	Sefirat
Sfiras	True	Sefirat
Sfirat	True	Sefirat
se'if	True	\N
seif	True	se'if
Segol	True	\N
seggol	True	Segol
Seggol	True	Segol
segol	True	Segol
sekilah	True	\N
s'kila	True	sekilah
s'kilah	True	sekilah
s'killa	True	sekilah
s'killah	True	sekilah
sekila	True	sekilah
sekilla	True	sekilah
sekillah	True	sekilah
skila	True	sekilah
skilah	True	sekilah
skilla	True	sekilah
skillah	True	sekilah
Selichot	True	\N
s'lichos	True	Selichot
S'lichos	True	Selichot
s'lichot	True	Selichot
S'lichot	True	Selichot
selichos	True	Selichot
Selichos	True	Selichot
selichot	True	Selichot
slichos	True	Selichot
Slichos	True	Selichot
slichot	True	Selichot
Slichot	True	Selichot
Sephardi	False	\N
sefardi	False	Sephardi
Sefardi	False	Sephardi
sefardic	False	Sephardi
Sefardic	False	Sephardi
sephardi	False	Sephardi
sephardic	False	Sephardi
Sephardic	False	Sephardi
Sephardim	False	\N
sefardim	False	Sephardim
Sefardim	False	Sephardim
sephardim	False	Sephardim
seudah	True	\N
se'uda	True	seudah
se'udah	True	seudah
seuda	True	seudah
Seudah	True	\N
Se'uda	True	Seudah
Se'udah	True	Seudah
Seuda	True	Seudah
seudat	True	\N
se'udas	True	seudat
se'udat	True	seudat
seudas	True	seudat
Seudat	True	\N
Se'udas	True	Seudat
Se'udat	True	Seudat
Seudas	True	Seudat
seudot	True	\N
se'udos	True	seudot
se'udot	True	seudot
seudos	True	seudot
Seudot	True	\N
Se'udos	True	Seudot
Se'udot	True	Seudot
Seudos	True	Seudot
sevara	True	\N
sevarah	True	sevara
sha'ah	True	\N
sha'a	True	sha'ah
shaa	True	sha'ah
shaah	True	sha'ah
Sha'ah	True	\N
Sha'a	True	Sha'ah
Shaa	True	Sha'ah
Shaah	True	Sha'ah
sha'at	True	\N
shaat	True	sha'at
Sha'at	True	\N
Shaat	True	Sha'at
Shabbat	False	\N
shabbat	False	Shabbat
shabbos	False	Shabbat
Shabbos	False	Shabbat
Shacharit	False	\N
shacharis	False	Shacharit
shacharit	False	Shacharit
shakharis	False	Shacharit
Shakharis	False	Shacharit
shakharit	False	Shacharit
Shakharit	False	Shacharit
shaliach	True	\N
sh'liach	True	shaliach
sh'liakh	True	shaliach
shaliakh	True	shaliach
sheliach	True	shaliach
sheliakh	True	shaliach
shliach	True	shaliach
shliakh	True	shaliach
Shaliach	True	\N
Sh'liach	True	Shaliach
Sh'liakh	True	Shaliach
Shaliakh	True	Shaliach
Sheliach	True	Shaliach
Sheliakh	True	Shaliach
Shliach	True	Shaliach
Shliakh	True	Shaliach
Shakh	True	\N
Shach	True	Shakh
Shavuot	False	\N
Shavuos	False	Shavuot
shebaleiv	False	\N
sh'baleiv	False	shebaleiv
sh'balev	False	shebaleiv
shebalev	False	shebaleiv
shibaleiv	False	shebaleiv
shibalev	False	shebaleiv
shebikdushah	True	\N
sh'bikdusha	True	shebikdushah
sh'bikdushah	True	shebikdushah
shebikdusha	True	shebikdushah
SheHakol	True	\N
sh'hakkol	True	SheHakol
Sh'hakkol	True	SheHakol
Sh'Hakkol	True	SheHakol
sh'hakol	True	SheHakol
Sh'hakol	True	SheHakol
Sh'Hakol	True	SheHakol
shehakkol	True	SheHakol
sheHakkol	True	SheHakol
Shehakkol	True	SheHakol
shehakol	True	SheHakol
sheHakol	True	SheHakol
Shehakol	True	SheHakol
sheini	True	\N
sheni	True	sheini
Shekhinah	True	\N
Sh'china	True	Shekhinah
Sh'chinah	True	Shekhinah
Sh'khina	True	Shekhinah
Sh'khinah	True	Shekhinah
Shechina	True	Shekhinah
Shechinah	True	Shekhinah
Shekhina	True	Shekhinah
Shekiah	True	\N
sh'ki'a	True	Shekiah
Sh'ki'a	True	Shekiah
sh'ki'ah	True	Shekiah
Sh'ki'ah	True	Shekiah
sh'kia	True	Shekiah
Sh'kia	True	Shekiah
sh'kiah	True	Shekiah
Sh'kiah	True	Shekiah
sh'kiya	True	Shekiah
Sh'kiya	True	Shekiah
sh'kiyah	True	Shekiah
Sh'kiyah	True	Shekiah
sheki'a	True	Shekiah
Sheki'a	True	Shekiah
sheki'ah	True	Shekiah
Sheki'ah	True	Shekiah
shekia	True	Shekiah
Shekia	True	Shekiah
shekiah	True	Shekiah
shekiya	True	Shekiah
Shekiya	True	Shekiah
shekiyah	True	Shekiah
Shekiyah	True	Shekiah
shki'a	True	Shekiah
Shki'a	True	Shekiah
shki'ah	True	Shekiah
Shki'ah	True	Shekiah
shkia	True	Shekiah
Shkia	True	Shekiah
shkiah	True	Shekiah
Shkiah	True	Shekiah
shkiya	True	Shekiah
Shkiya	True	Shekiah
shkiyah	True	Shekiah
Shkiyah	True	Shekiah
Shekiat	True	\N
sh'ki'at	True	Shekiat
Sh'ki'at	True	Shekiat
sh'kiat	True	Shekiat
Sh'kiat	True	Shekiat
sh'kiyat	True	Shekiat
Sh'kiyat	True	Shekiat
sheki'at	True	Shekiat
Sheki'at	True	Shekiat
shekiat	True	Shekiat
shekiyat	True	Shekiat
Shekiyat	True	Shekiat
shki'at	True	Shekiat
Shki'at	True	Shekiat
shkiat	True	Shekiat
Shkiat	True	Shekiat
shkiyat	True	Shekiat
Shkiyat	True	Shekiat
shelishi	True	\N
shlishi	True	shelishi
Shelishit	True	\N
sh'lishis	True	Shelishit
Sh'lishis	True	Shelishit
sh'lishit	True	Shelishit
Sh'lishit	True	Shelishit
shelishis	True	Shelishit
Shelishis	True	Shelishit
shelishit	True	Shelishit
shlishis	True	Shelishit
Shlishis	True	Shelishit
shlishit	True	Shelishit
Shlishit	True	Shelishit
שליטא	False	\N
sh'lita	False	שליטא
Sh'lita	False	שליטא
sh'litah	False	שליטא
Sh'litah	False	שליטא
shalita	False	שליטא
Shalita	False	שליטא
shalitah	False	שליטא
Shalitah	False	שליטא
shelita	False	שליטא
Shelita	False	שליטא
shelitah	False	שליטא
Shelitah	False	שליטא
shlita	False	שליטא
Shlita	False	שליטא
shlitah	False	שליטא
Shlitah	False	שליטא
Shema	False	\N
sh'ma	False	Shema
Sh'ma	False	Shema
shema	False	Shema
shma	False	Shema
Shma	False	Shema
Shemini	False	\N
sh'mini	False	Shemini
Sh'mini	False	Shemini
shemini	False	Shemini
shmini	False	Shemini
Shmini	False	Shemini
shemirah	True	\N
sh'mira	True	shemirah
sh'mirah	True	shemirah
shemira	True	shemirah
shmira	True	shemirah
shmirah	True	shemirah
shemirat	True	\N
sh'miras	True	shemirat
sh'mirat	True	shemirat
shemiras	True	shemirat
shmiras	True	shemirat
shmirat	True	shemirat
Shemoneh	True	\N
sh'mone	True	Shemoneh
Sh'mone	True	Shemoneh
sh'moneh	True	Shemoneh
Sh'moneh	True	Shemoneh
shemone	True	Shemoneh
Shemone	True	Shemoneh
shemoneh	True	Shemoneh
shmone	True	Shemoneh
Shmone	True	Shemoneh
shmoneh	True	Shemoneh
Shmoneh	True	Shemoneh
Shemot	False	\N
Sh'mos	False	Shemot
Sh'mot	False	Shemot
Shemos	False	Shemot
Shmos	False	Shemot
Shmot	False	Shemot
shetar	True	\N
sh'tar	True	shetar
shtar	True	shetar
Sheva	True	\N
shevah	True	Sheva
Shevah	True	Sheva
shevut	True	\N
sh'vus	True	shevut
sh'vut	True	shevut
shevus	True	shevut
shvus	True	shevut
shvut	True	shevut
shinuy	True	\N
shinnuy	True	shinuy
shivah	True	\N
shiva	True	shivah
Shivah	True	\N
Shiva	True	Shivah
Shokhein	True	\N
shochein	True	Shokhein
Shochein	True	Shokhein
shochen	True	Shokhein
Shochen	True	Shokhein
shokhein	True	Shokhein
shokhen	True	Shokhein
Shokhen	True	Shokhein
Shulchan	True	\N
Shulkhan	True	Shulchan
Shulchan Arukh	True	\N
SA	True	Shulchan Arukh
siddur	False	\N
sidur	False	siddur
Siddur	False	\N
Sidur	False	Siddur
sifrei	True	\N
Sifrai	True	sifrei
Sifray	True	sifrei
Sifri	True	\N
sifri	True	Sifri
siman	True	\N
simin	True	siman
Simchat	False	\N
Simchas	False	Simchat
skhar	True	\N
s'char	True	skhar
s'khar	True	skhar
schar	True	skhar
sechar	True	skhar
sekhar	True	skhar
sofeir	True	\N
sofer	True	sofeir
Sofer	True	\N
Sofeir	True	Sofer
soledet	True	\N
soleddet	True	soledet
Sotah	True	\N
Sota	True	Sotah
Sotta	True	Sotah
Sottah	True	Sotah
Sukkah	False	\N
Sukah	False	Sukkah
Sukka	False	Sukkah
Sukkot	False	\N
Sukkos	False	Sukkot
Sukos	False	Sukkot
Sukot	False	Sukkot
ta'am	True	\N
taam	True	ta'am
ta'amei	True	\N
ta'amai	True	ta'amei
taamay	True	ta'amei
taamei	True	ta'amei
ta'anit	True	\N
taanis	True	ta'anit
taanit	True	ta'anit
Ta'anit	True	\N
Taanit	True	Ta'anit
Taynis	True	Ta'anit
ta'arovet	True	\N
ta'aroves	True	ta'arovet
taaroves	True	ta'arovet
taarovet	True	ta'arovet
Tachanun	True	\N
tachanun	True	Tachanun
shalom	True	\N
takhanun	True	Tachanun
Takhanun	True	Tachanun
takanah	True	\N
takana	True	takanah
takanna	True	takanah
takannah	True	takanah
takanat	True	\N
Takanas	True	takanat
Takannas	True	takanat
Takannat	True	takanat
tallit	True	\N
talis	True	tallit
talit	True	tallit
tallis	True	tallit
Tammuz	True	\N
tammuz	True	Tammuz
tamuz	True	Tammuz
Tamuz	True	Tammuz
Tashlikh	True	\N
tashlich	True	Tashlikh
Tashlich	True	Tashlikh
tashlikh	True	Tashlikh
tavlin	True	\N
tavllin	True	tavlin
tavshil	True	\N
tavshill	True	tavshil
Tavshilin	True	\N
tavshilin	True	Tavshilin
tavshillin	True	Tavshilin
Tavshillin	True	Tavshilin
Taz	True	\N
taz	True	Taz
tefilah	True	\N
t'fila	True	tefilah
t'filah	True	tefilah
t'filla	True	tefilah
t'fillah	True	tefilah
tefila	True	tefilah
tefilla	True	tefilah
tefillah	True	tefilah
tfila	True	tefilah
tfilah	True	tefilah
tfilla	True	tefilah
tfillah	True	tefilah
tefillin	True	\N
t'filin	True	tefillin
t'fillin	True	tefillin
tefilin	True	tefillin
tfilin	True	tefillin
tfillin	True	tefillin
tekiah	True	\N
tekia	True	tekiah
tekiot	True	\N
tekios	True	tekiot
tekufah	True	\N
t'kufa	True	tekufah
t'kufah	True	tekufah
t'kupha	True	tekufah
t'kuphah	True	tekufah
tekufa	True	tekufah
tekupha	True	tekufah
tekuphah	True	tekufah
tekufat	True	\N
t'kufas	True	tekufat
t'kufat	True	tekufat
t'kuphas	True	tekufat
t'kuphat	True	tekufat
tekufas	True	tekufat
tekuphas	True	tekufat
tekuphat	True	tekufat
tereifot	True	\N
t'refos	True	tereifot
t'refot	True	tereifot
t'reifos	True	tereifot
t'reifot	True	tereifot
terefos	True	tereifot
terefot	True	tereifot
tereifos	True	tereifot
trefos	True	tereifot
trefot	True	tereifot
treifos	True	tereifot
treifot	True	tereifot
teshuva	True	\N
t'shuva	True	teshuva
t'shuvah	True	teshuva
teshuvah	True	teshuva
tshuva	True	teshuva
tshuvah	True	teshuva
Teshuva	True	\N
T'shuva	True	Teshuva
T'shuvah	True	Teshuva
Teshuvah	True	Teshuva
Tshuva	True	Teshuva
Tshuvah	True	Teshuva
teshuvot	True	\N
t'shuvot	True	teshuvot
tshuvot	True	teshuvot
terumah	True	\N
t'ruma	True	terumah
t'rumah	True	terumah
teruma	True	terumah
truma	True	terumah
trumah	True	terumah
terumot	True	\N
t'rumos	True	terumot
t'rumot	True	terumot
terumos	True	terumot
trumos	True	terumot
trumot	True	terumot
tevilah	True	\N
t'vila	True	tevilah
t'vilah	True	tevilah
t'villa	True	tevilah
t'villah	True	tevilah
tevila	True	tevilah
tevilla	True	tevilah
tevillah	True	tevilah
tvila	True	tevilah
tvilah	True	tevilah
tvilla	True	tevilah
tvillah	True	tevilah
tevilat	True	\N
t'vilat	True	tevilat
t'villat	True	tevilat
tevillat	True	tevilat
tvilat	True	tevilat
tvillat	True	tevilat
tircha	True	\N
tirchah	True	tircha
tirkha	True	tircha
tirkhah	True	tircha
Tisha	False	\N
tisha	False	Tisha
Tishah	False	Tisha
Tishrei	False	\N
tishray	False	Tishrei
Tishray	False	Tishrei
tishrei	False	Tishrei
Tosafot	True	\N
Tosafos	True	Tosafot
Tosefot	True	Tosafot
Tosephot	True	Tosafot
Tosfos	True	Tosafot
Tosfot	True	Tosafot
Tosphot	True	Tosafot
Torah	False	\N
Toreh	False	Torah
Toyre	False	Torah
tovel	True	\N
toivel	True	tovel
toveil	True	tovel
treif	True	\N
trayf	True	treif
Tzeit	True	\N
tzeis	True	Tzeit
Tzeis	True	Tzeit
tzeit	True	Tzeit
tzibur	True	\N
tzibbur	True	tzibur
tzitzit	True	\N
tzitzis	True	tzitzit
tzorekh	True	\N
tzorech	True	tzorekh
Ushpizin	True	\N
ushpizin	True	Ushpizin
ushpizzin	True	Ushpizin
Ushpizzin	True	Ushpizin
Viduy	True	\N
Vidui	True	Viduy
Yabia	True	\N
Yabiah	True	Yabia
yatom	True	\N
yasom	True	yatom
yattom	True	yatom
Yatom	True	\N
Yasom	True	Yatom
Yattom	True	Yatom
yeish	True	\N
yesh	True	yeish
Yerushalmi	True	\N
yerushalmi	True	Yerushalmi
Yerushalayim	True	\N
Yerushallayim	True	Yerushalayim
Yevamot	True	\N
yevamos	True	Yevamot
Yevamos	True	Yevamot
yevamot	True	Yevamot
Yigdal	True	\N
yigdal	True	Yigdal
Yishtabach	False	\N
Yishtabakh	False	Yishtabach
Yisrael	True	\N
yisrael	True	Yisrael
yisroel	True	Yisrael
Yisroel	True	Yisrael
Yizkor	False	\N
Yiskor	False	Yizkor
Yoreh	True	\N
Yore	True	Yoreh
Yom Tov	False	\N
Yuntif	False	Yom Tov
Yuntiv	False	Yom Tov
Zarah	True	\N
Zara	True	Zarah
zarah	True	\N
zara	True	zarah
zemirot	True	\N
z'miros	True	zemirot
z'mirot	True	zemirot
zemiros	True	zemirot
zmiros	True	zemirot
zmirot	True	zemirot
Zemirot	True	\N
Z'miros	True	Zemirot
Z'mirot	True	Zemirot
Zemiros	True	Zemirot
Zmiros	True	Zemirot
Zmirot	True	Zemirot
zenut	True	\N
z'nus	True	zenut
z'nut	True	zenut
zenus	True	zenut
zera	True	\N
zerah	True	zera
Zimmun	True	\N
Zimun	True	Zimmun
zonah	True	\N
zona	True	zonah
ad	True	\N
Ad	True	\N
akum	True	\N
al	True	\N
Al	True	\N
alef	True	\N
aliyot	True	\N
Anim	True	\N
av	True	\N
avad	True	\N
ben	True	\N
bentch	True	\N
bishul	True	\N
bo	True	\N
davar	True	\N
Davar	True	\N
davka	True	\N
EH	True	\N
frum	True	\N
gadol	True	\N
gedolim	True	\N
Gedolim	True	\N
goy	True	\N
goyim	True	\N
HaShevach	True	\N
ish	True	\N
Ish	True	\N
Kaf	True	\N
kashrut	True	\N
Kashrut	True	\N
kedushat	True	\N
klaf	True	\N
makom	True	\N
mikdash	True	\N
Mikdash	True	\N
Mila	True	\N
minhagim	True	\N
minyan	True	\N
Minyan	True	\N
mishnayot	True	\N
Mishnayot	True	\N
Mishpat	True	\N
nashim	True	\N
Nashim	True	\N
nisa	True	\N
pirsum	True	\N
pirsumei	True	\N
poskim	True	\N
Pri	True	\N
rishon	True	\N
rov	True	\N
Rov	True	\N
shas	True	\N
Shas	True	\N
sheva	True	\N
shevach	True	\N
shevakh	True	\N
shitah	True	\N
shitot	True	\N
shul	True	\N
Sifrei	True	\N
siluk	True	\N
simchah	True	\N
snif	True	\N
sugya	True	\N
sugyot	True	\N
Sugyot	True	\N
Takanat	True	\N
tereifah	True	\N
Teshuvot	True	\N
tov	True	\N
Tov	True	\N
Tu	True	\N
Tur	True	\N
Vayigash	True	\N
yachid	True	\N
yad	True	\N
YD	True	\N
yechidim	True	\N
yichud	True	\N
yom	True	\N
yomo	True	\N
yotzei	True	\N
Zeved	True	\N
Zohar	True	\N
haguf	True	\N
ha'guf	True	haguf
sh'vach	True	shevach
shivach	True	shevach
sh'vakh	True	shevakh
shivakh	True	shevakh
re	False	\N
regarding	False	re
